#############################
#A        ###################            
# ######  ###################
#                           #
# ################### #######
# ################### #######
# ################       ####
# ################ ##### ####
# ################   B   ####
# ################ ### ######
# ################ ### ######
#                           #
#############################